3 13 31
###############################
#p       *    **   1  *       #
# # # #s# # # # # #*# #*# # # #
#    *        **        1     #
# #b# # # #*# # #*# # # # # #*#
#f *     4  *x        *       #
# # # # # # # # # #*# # # # # #
#     *  *        **b         #
#*#*# # # # #*# # # # # # #*# #
#    *f          *      *  6  #
# # # # # #*# #2#*# # # #*# # #
#*  3   *        * 5      *   #
###############################